###########
#..#......#
#..#......#
#..#......#
#..#......#
#..#...#..#
#......#..#
#......#..#
#......#..#
#......#..#
###########
