###########
#.........#
#.........#
#..#####..#
#.........#
#..#####..#
#.........#
#..#####..#
#.........#
#.........#
###########
