###########
#.........#
#.........#
#....#....#
#....#....#
#....#....#
#....#....#
#....#....#
#.........#
#.........#
###########
